7 10 1 1 1 1 1 1 1 1 1 1
1 2 1 8 1 1 11 1 1 1
1 5 1 2 1 1 2 1 1 1
1 2 1 7 10 2 2 2 2 1
1 2 2 9 0 1 2 2 2 1
1 6 1 2 1 1 1 1 1 1
1 1 1 1 1 1 1 1 1 1
