9 12 1 1 1 1 1 1 1 1 1 1 1 1
1 1 1 1 1 1 11 2 2 2 2 1
1 1 1 1 2 10 2 2 2 2 2 1
1 1 1 1 2 1 2 1 2 2 2 1
1 1 1 1 2 1 2 1 1 1 1 1
1 8 2 2 7 2 9 1 1 1 1 1
1 1 1 1 2 5 2 6 1 1 1 1
1 4 2 2 2 1 0 1 1 1 1 1
1 1 1 1 1 1 1 1 1 1 1 1