9 9 1 1 1 1 1 1 1 1 1
1 2 1 1 1 1 1 1 1
1 2 10 2 2 2 2 11 1
1 6 1 1 1 1 2 1 1
1 5 1 0 2 7 2 8 1
1 2 2 2 2 2 2 2 1
1 1 1 9 2 1 1 1 1
1 1 1 2 2 1 1 1 1
1 1 1 1 1 1 1 1 1